


NO ./textures/text1.xpm
SO ./textures/text2.xpm
WE ./textures/text3.xpm
EA ./textures/text4.xpm



F 0,255,100
C 255,225,255


1111111111111111111111111   
1000000000000000000000001
100000000000E000000000001
1000000000000000000000001
100UUUUUUUUUUUUUUUUUUUU01
100UUUUUUUUUUUUUUUUUUUU01
100UUUUUUUUUUUUUUUUUUUU01
100UUUUUUUUUUUUUUUUUUUU01
1000000000000000000000001
1000000000000000000000001
1000000000000000000000001
1000000000000000000000001
1020000000000000000002001
1000000000000000000000001
1000000000000000000000001
1111111111111111111111111   
