


NO ./textures/text1.xpm
SO ./textures/text2.xpm
WE ./textures/text3.xpm
EA ./textures/text4.xpm



F 0,255,100
C 0,225,255








1    11111111111111111111111111111111111111111111111111111
11111111111000000000000000000000000010000000110001111111111111111111111111111111111111
100W000U0000000100000000000000000000000001111111111111                               1
1000000000000002000000000000000000010000000001
1100000000111111111110111111111111000110000001  
100000000000000100011111000100011001000000001
100000000000000011001000000000000000100000001
11100000000000000000000000000000000000000000011
 111110000000000000000000000000001000010000011
100000000U00000000100000000000000000000000001
100000000000000000100000100000000000000000001
10000000000U000000000001 100000000000000000001
1000000000000111000000001000000020000111000001
100000000000000100000000011000000000110000111
100000000000000100100000000000000000111100001
111100000000000100000000000000000000000100001
11111111111111111111111111111111111111111111111111111111111111111111

