NO ./textures/text1.xpm
SO ./textures/text2.xpm
WE ./textures/text3.xpm
EA ./textures/text4.xpm

F 255,100,0
C 225,30,100

111111111111111111111111111111111111111111111
111111111110000000000000000000000000100000001
10E0000U0000000100000000000000000000000001111
100000000000000200000000000000000010000000001
110000000011111111111111111111111000110000001
100000000000000100011111000100011001000000001
100000000000000110010000000000000001000000001
100000000000000000000000000000000000000000001
100000000000000000000000000010000100000000001
100000000U00000000100000000000000000000000001
100000000000000000100000000000000000000000001
10000000000U000000000000000000000000000000001
100000000000011100000000000000000000111000001
100000000000000100000000011000000000110000111
100000000000000100100000000000000000111100001
100000000000000100000000000000000000000100001
111111111111111111111111111111111111111111111