


SO ./textures/w1.xpm
EA ./textures/w1.xpm
NO ./textures/w1.xpm
WE ./textures/w1.xpm




F 2,255,100
C 255,225,255

1
1111111111111111111111111111111111111111111111111111111111111111111111111111111111111111111111111
1000000000000000000000000000000000000000000000000000000000000000000000000000000000000000000000001
1111111111111111111111110000000000000000000000000000000000000000000000000000000000000000000000001
1000000000000000000000000000000000000000000000000000000000000000000000000000000000000000000000001
1000000000000000000000000000000000000000000000000000000000000000000000000000000000000000000000001
1000000000000000000000000000000000000000000000000000000000000000000000000000000000000000000000001
1000000000000000000000000000000000000000000000000000000000000000000000000000000000000000000000001
100000000W000000000000000000000000000000000000000000000000000000000000000000000000000000000000001
1000000000000000000000001111111111111111111111111111111111111111111111111111111111111111111111111
1000000000000000000000001
1000000000000000000000001
1111111111111111111111111   
