11111111111
1  11
1 10111111111111111111111111111111111111111111111111111111
1110W0000000000000000000000010000000110001111111111111111111111111111111111111
111111111111111111111111111111111111111111111111111111111111111111111111111111111111111111111111111
