

SO ./textures/text2.xpm
EA ./textures/text4.xpm
NO ./textures/text1.xpm
WE ./textures/text3.xpm




F 2,255,100
C 255,225,255

111111111111
10S000000001
100000000001
100000U00201
100000000001
100200000001
100000000001
111111111111